╔══════════════════════════════════════════╗
║         EMOJI ROSETTA STONE v1.0         ║
║       "if you can read this, good luck"  ║
╚══════════════════════════════════════════╝

┌──────────── KEYWORDS ────────────┐
│ 💀  →  return                    │
│ 🔥  →  int                      │
│ 🎯  →  main                     │
│ 🤡  →  if                       │
│ 🍕  →  for                      │
│ 🧠  →  strlen                   │
│ 💣  →  char                     │
│ 🗑️  →  void                     │
│ 💩  →  printf                   │
│ 😈  →  static                   │
│ 🍔  →  unsigned                 │
│ 🧊  →  sizeof                   │
│ 🫠  →  exit                     │
└──────────────────────────────────┘

┌──────────── OPERATORS ───────────┐
│ 🤯  →  ++                       │
│ 🦷  →  ^                        │
│ 🧃  →  +                        │
│ 🎲  →  %                        │
│ 🐸  →  <                        │
│ 🤮  →  !=                       │
│ 🥶  →  ==                       │
└──────────────────────────────────┘

┌──────────── SYNTAX ──────────────┐
│ 🎭  →  {                        │
│ 🪦  →  }                        │
│ 🫣  →  ;                        │
└──────────────────────────────────┘

┌──────────── NUMBERS ─────────────┐
│ 🎪  →  0                        │
│ 🏆  →  1                        │
│ 🎱  →  2                        │
│ 🎃  →  25                       │
│ 🧅  →  0xDE                     │
│ 🧄  →  0xAD                     │
│ 🥦  →  0xBE                     │
│ 🍆  →  0xEF                     │
│ 🥕  →  0xCA                     │
│ 🌽  →  0xFE                     │
│ 🦴  →  179                      │
│ 🦠  →  205                      │
│ 🧟  →  198                      │
│ 🦂  →  145                      │
│ 🕷️  →  170                      │
│ 🦇  →  164                      │
│ 🐙  →  171                      │
│ 🦑  →  207                      │
│ 🐝  →  219                      │
│ 🦟  →  232                      │
│ 🪳  →  218                      │
│ 🦎  →  141                      │
│ 🐊  →  239                      │
│ 🦈  →  237                      │
│ 🐋  →  201                      │
│ 🦭  →  178                      │
│ 🐡  →  235                      │
│ 🦩  →  224                      │
│ 🦚  →  177                      │
│ 🦜  →  271                      │
│ 🐳  →  187                      │
└──────────────────────────────────┘

┌──────────── STRINGS ─────────────┐
│ 🔮  →  "Usage: %s <flag>\n"     │
│ 💔  →  "nah fam\n"              │
│ 🧨  →  "nope @ %d\n"            │
│ 🏁  →  "correct!\n"             │
└──────────────────────────────────┘

┌──────────── VARIABLES ───────────┐
│ 🌭  →  ???                      │
│ 🍟  →  ???                      │
│ 🎰  →  ???                      │
│ 🦧  →  ???                      │
│ 🐒  →  ???                      │
│ 🐍  →  ???                      │
│ 🦊  →  ???                      │
│ 🐛  →  ???                      │
│ 🌮  →  ???                      │
│ 🥊  →  ???                      │
│ 🎁  →  ???                      │
└──────────────────────────────────┘
  ^ figure these out yourself lol
